12
1,5,7,5,5,5,5,6,3,7,5,4
3,5,12,3,5,6,2,10,8,10,3,6
10,3,5,12,2,10,10,9,5,13,12,10
10,9,5,5,12,10,9,5,5,7,5,12
9,5,5,5,7,13,7,5,5,14,3,6
3,7,7,6,8,3,14,3,6,10,11,14
9,13,12,11,6,9,12,10,9,13,12,10
3,5,5,13,15,7,5,15,5,7,7,14
11,4,1,7,15,13,7,13,6,9,14,10
11,5,6,10,9,7,13,5,15,7,14,8
11,5,12,10,2,9,5,6,10,8,9,6
9,5,5,13,13,5,5,12,9,5,5,12